[
  {
    "id": "crate_ship_cargo",
    "type": "item_group",
    "subtype": "distribution",
    "items": [ { "group": "military", "prob": 100 } ]
  },
  {
    "type": "mapgen",
    "method": "json",
    "om_terrain": [ [ "cargo_ship_a", "cargo_ship_b", "cargo_ship_c" ] ],
    "weight": 100,
    "object": {
      "fill_ter": "t_lake_bed",
      "rows": [
        ";;;;;;;;;;;;;;;;;;;;;;;;;;;;;;;;;;;;;;;;;;;;;;;;;;;;;;;;;;;;;;;;;;;;;;;;",
        ";;;;;;;;;;;;;;;;;;;;;;;;;;;;;;;;;;;;;;;;;;;;;;;;;;;;;;;;;;;;;;;;;;;;;;;;",
        ";;;;;;;;;;;;;;;;;;;;;;;;;;;;;;;;;;;;;;;;;;;;;;;;;;;;;;;;;;;;;;;;;;;;;;;;",
        ";;;;;;aaaaaaaaaaaaaaaaaaaaaaaaaaaaaaaaaaaaaaaaaaaaaaaaaaa||||o|||||o||;;",
        ";;;;aaa                                                  oiiiiiDFiiid||;",
        ";;aaa   ||||||||  ||||||||  ||||||||  ||||||||  |||||||| +iiiiiiiiiiii||",
        "aaa     |...m..j  |g...g.j  |...m..j  |g.gg..j  |m.....j |iiiiiiiiiiiiio",
        "a       |mm....j  |ggg...j  |mm...mj  |g....gj  |m.m.m.j ||||+||||||+|||",
        "a       ||||||||  ||||||||  ||||||||  ||||||||  |||||||| |iiiiiii|@@i@@|",
        "a                                                        oiQiiiQi|iiiii|",
        "a       ||||||||  ||||||||  ||||||||  ||||||||  |||||||| |iQiiiQi|@@i@@o",
        "a       |mm.m..j  |g..gggj  |gg....j  |m....mj  |..g...j |iQiiiii|iiiii|",
        "a       |m....mj  |g.....j  |g..gg.j  |m.mm..j  |g....gj |iQii||||@@i@@|",
        "a       ||||||||  ||||||||  ||||||||  ||||||||  |||||||| |iQii|St|iiiiio",
        "a                                                        oiQii|ii|@@i@@|",
        "a       ||||||||  ||||||||  ||||||||  ||||||||  |||||||| |iiii|Ui|iiiii|",
        "a       |..gg.gj  |...m..j  |......j  |g...ggj  |mm..m.j ||||+||+|||+|||",
        "aaa     |g.....j  |.m...mj  |gg.g.gj  |g.g...j  |......j |iiiiiiiiiiiiio",
        ";;aaa   ||||||||  ||||||||  ||||||||  ||||||||  |||||||| +iiiiiiiiiiii||",
        ";;;;aaa                                                  oiiiiiDFiiid||;",
        ";;;;;;aaaaaaaaaaaaaaaaaaaaaaaaaaaaaaaaaaaaaaaaaaaaaaaaaaa||||o|||||o||;;",
        ";;;;;;;;;;;;;;;;;;;;;;;;;;;;;;;;;;;;;;;;;;;;;;;;;;;;;;;;;;;;;;;;;;;;;;;;",
        ";;;;;;;;;;;;;;;;;;;;;;;;;;;;;;;;;;;;;;;;;;;;;;;;;;;;;;;;;;;;;;;;;;;;;;;;",
        ";;;;;;;;;;;;;;;;;;;;;;;;;;;;;;;;;;;;;;;;;;;;;;;;;;;;;;;;;;;;;;;;;;;;;;;;"
      ],
      "vendingmachines": { "D": { "item_group": "vending_drink" }, "F": { "item_group": "vending_food" } },
      "toilets": { "t": {  } },
      "gaspumps": { "!": {  } },
      "items": {
        "Q": { "item": "cannedfood", "chance": 0 },
        "S": { "item": "SUS_bathroom_cabinet", "chance": 0 },
        "g": { "item": "crate_parts", "chance": 0 },
        "m": { "item": "crate_parts", "chance": 0 }
      },
      "furniture": {
        "C": "f_workbench",
        "c": "f_cupboard",
        "1": "f_control_station",
        "A": "f_air_compressor",
        "f": "f_tourist_table",
        "&": "f_cleat",
        "@": "f_bed",
        "B": "f_sample_freezer",
        "E": "f_shaker",
        "G": "f_stool",
        "H": "f_counter",
        "I": "f_IV_pole",
        "J": "f_curtain",
        "K": "f_fridge",
        "Q": "f_rack",
        "S": "f_sink",
        "U": "f_shower",
        "W": "f_water_purifier",
        "b": "f_bench",
        "h": "f_camp_chair",
        "l": "f_foot_locker",
        "g": "f_crate_c",
        "m": "f_crate_c"
      },
      "terrain": {
        " ": "t_bulkhead_floor",
        "`": "t_bulkhead_roof",
        ";": "t_lake_bed",
        "+": "t_door_metal_bulkhead_c",
        "#": "t_metal_pontoon_dp",
        "2": "t_machinery_electronic",
        "j": "t_door_metal_locked",
        "*": "t_water_pool",
        "m": "t_metal_floor",
        "-": "t_water_cube",
        ".": "t_metal_floor",
        "<": "t_ladder_up",
        "|": "t_wall_bulkhead",
        ">": "t_ladder_down",
        "~": "t_water_dp",
        "A": "t_metal_floor",
        "P": "t_concrete_dock_deep_pile",
        "^": "t_lake_bed_concrete",
        "o": "t_porthole",
        "y": "t_lake_bed_concrete_yellow",
        "@": "t_bulkhead_floor",
        "a": "t_metal_railing",
        "d": "t_stairs_up",
        "e": "t_stairs_down",
        "g": "t_metal_floor",
        "i": "t_bulkhead_floor"
      }
    }
  },
  {
    "type": "mapgen",
    "method": "json",
    "om_terrain": [ [ "cargo_ship_1_a", "cargo_ship_1_b", "cargo_ship_1_c" ] ],
    "weight": 100,
    "object": {
      "fill_ter": "t_lake_bed",
      "rows": [
        "~~~~~~~~~~~~~~~~~~~~~~~~~~~~~~~~~~~~~~~~~~~~~~~~~~~~~~~~~~~~~~~~~~~~~~~~",
        "~~~~~~~~~~~~~~~~~~~~~~~~~~~~~~~~~~~~~~~~~~~~~~~~~~~~~~~~~~~~~~~~~~~~~~~~",
        "~~~~~~~~~~~~~~~~~~~~~~~~~~~~~~~~~~~~~~~~~~~~~~~~~~~~~~~~~~~~~~~~~~~~~~~~",
        "~~~~~~~~~~~~~~~~~~~~~~~~~~~~~~~~~~~~~~~~~~~~~~~~~~~~~~~~~||||o|||||o||~~",
        "~~~~~~~~~~~~~~~~~~~~~~~~~~~~~~~~~~~~~~~~~~~~~~~~~~~~~~~~~| 22 22    e||~",
        "~~~~~~~~||||||||~~||||||||~~||||||||~~||||||||~~||||||||~o            ||",
        "~~~~~~~~|g..g..i~~|gg.g..i~~|m.m...i~~|.....gi~~|g.gg..i~|             o",
        "~~~~~~~~|gg...gi~~|g....gi~~|m...mmi~~|g.gg..i~~|g....gi~||||+||      W|",
        "~~~~~~~~||||||||~~||||||||~~||||||||~~||||||||~~||||||||~|     |      2|",
        "~~~~~~~~~~~~~~~~~~~~~~~~~~~~~~~~~~~~~~~~~~~~~~~~~~~~~~~~~o     |2     E|",
        "~~~~~~~~||||||||~~||||||||~~||||||||~~||||||||~~||||||||~o CC  |       o",
        "~~~~~~~~|m....mi~~|..gg..i~~|mm...mi~~|...g..i~~|m..m..i~o CG  |W      |",
        "~~~~~~~~|m.mm..i~~|g....gi~~|m..m..i~~|.g...gi~~|mm...mi~o CG  |A      |",
        "~~~~~~~~||||||||~~||||||||~~||||||||~~||||||||~~||||||||~o CC  |       o",
        "~~~~~~~~~~~~~~~~~~~~~~~~~~~~~~~~~~~~~~~~~~~~~~~~~~~~~~~~~o     |2     2|",
        "~~~~~~~~||||||||~~||||||||~~||||||||~~||||||||~~||||||||~|     |      A|",
        "~~~~~~~~|gg...gi~~|..m...i~~|g...g.i~~|mmm...i~~|gg...gi~||||+||      2|",
        "~~~~~~~~|g..g..i~~|m...mmi~~|ggg...i~~|....mmi~~|g..g..i~|             o",
        "~~~~~~~~||||||||~~||||||||~~||||||||~~||||||||~~||||||||~o            ||",
        "~~~~~~~~~~~~~~~~~~~~~~~~~~~~~~~~~~~~~~~~~~~~~~~~~~~~~~~~~| 22 22    e||~",
        "~~~~~~~~~~~~~~~~~~~~~~~~~~~~~~~~~~~~~~~~~~~~~~~~~~~~~~~~~||||o|||||o||~~",
        "~~~~~~~~~~~~~~~~~~~~~~~~~~~~~~~~~~~~~~~~~~~~~~~~~~~~~~~~~~~~~~~~~~~~~~~~",
        "~~~~~~~~~~~~~~~~~~~~~~~~~~~~~~~~~~~~~~~~~~~~~~~~~~~~~~~~~~~~~~~~~~~~~~~~",
        "~~~~~~~~~~~~~~~~~~~~~~~~~~~~~~~~~~~~~~~~~~~~~~~~~~~~~~~~~~~~~~~~~~~~~~~~"
      ],
      "vendingmachines": { "D": { "item_group": "vending_drink" }, "F": { "item_group": "vending_food" } },
      "toilets": { "t": {  } },
      "gaspumps": { "!": {  } },
      "items": {
        "g": { "item": "science", "chance": 100, "repeat": [ 2, 3 ] },
        "m": { "item": "military", "chance": 100, "repeat": [ 2, 3 ] }
      },
      "furniture": {
        "C": "f_workbench",
        "c": "f_cupboard",
        "1": "f_control_station",
        "A": "f_air_compressor",
        "f": "f_tourist_table",
        "&": "f_cleat",
        "@": "f_bed",
        "B": "f_sample_freezer",
        "E": "f_shaker",
        "G": "f_stool",
        "H": "f_counter",
        "I": "f_IV_pole",
        "J": "f_curtain",
        "K": "f_fridge",
        "Q": "f_rack",
        "S": "f_sink",
        "U": "f_shower",
        "W": "f_water_purifier",
        "b": "f_bench",
        "h": "f_camp_chair",
        "l": "f_foot_locker",
        "g": "f_crate_c",
        "m": "f_crate_c"
      },
      "terrain": {
        " ": "t_bulkhead_floor",
        "`": "t_bulkhead_roof",
        ";": "t_lake_bed",
        "+": "t_door_metal_bulkhead_c",
        "#": "t_metal_pontoon_dp",
        "2": "t_machinery_electronic",
        "*": "t_water_pool",
        "m": "t_metal_floor",
        "-": "t_water_cube",
        ".": "t_metal_floor",
        "<": "t_ladder_up",
        "|": "t_wall_bulkhead",
        ">": "t_ladder_down",
        "~": "t_water_cube",
        "A": "t_metal_floor",
        "P": "t_concrete_dock_deep_pile",
        "^": "t_lake_bed_concrete",
        "o": "t_porthole",
        "y": "t_lake_bed_concrete_yellow",
        "a": "t_metal_railing",
        "d": "t_stairs_up",
        "e": "t_stairs_down",
        "g": "t_metal_floor",
        "i": "t_door_metal_locked"
      }
    }
  },
  {
    "type": "mapgen",
    "method": "json",
    "om_terrain": [ [ "cargo_ship_2_a", "cargo_ship_2_b", "cargo_ship_2_c" ] ],
    "weight": 100,
    "object": {
      "fill_ter": "t_lake_bed",
      "rows": [
        ";;;;;;;;;;;;;;;;;;;;;;;;;;;;;;;;;;;;;;;;;;;;;;;;;;;;;;;;;;;;;;;;;;;;;;;;",
        ";;;;;;;;;;;;;;;;;;;;;;;;;;;;;;;;;;;;;;;;;;;;;;;;;;;;;;;;;;;;;;;;;;;;;;;;",
        ";;;;;;;;;;;;;;;;;;;;;;;;;;;;;;;;;;;;;;;;;;;;;;;;;;;;;;;;;;;;;;;;;;;;;;;;",
        ";;;;;;aaaaaaaaaaaaaaaaaaaaaaaaaaaaaaaaaaaaaaaaaaaaaaaaaaa||||o|||||o||;;",
        ";;;;aaa                                                  oiiiiiDFiiid||;",
        ";;aaa   ||||||||  ||||||||  ||||||||  ||||||||  |||||||| +iiiiiiiiiiii||",
        "aaa     |...m..j  |g...g.j  |...m..j  |g.gg..j  |m.....j |iiiiiiiiiiiiio",
        "a       |mm....j  |ggg...j  |mm...mj  |g....gj  |m.m.m.j ||||+||||||+|||",
        "a       ||||||||  ||||||||  ||||||||  ||||||||  |||||||| |iiiiiii|@@i@@|",
        "a                                                        oiQiiiQi|iiiii|",
        "a       ||||||||  ||||||||  ||||||||  ||||||||  |||||||| |iQiiiQi|@@i@@o",
        "a       |mm.m..j  |g..gggj  |gg....j  |m....mj  |..g...j |iQiiiii|iiiii|",
        "a       |m....mj  |g.....j  |g..gg.j  |m.mm..j  |g....gj |iQii||||@@i@@|",
        "a       ||||||||  ||||||||  ||||||||  ||||||||  |||||||| |iQii|St|iiiiio",
        "a                                                        oiQii|ii|@@i@@|",
        "a       ||||||||  ||||||||  ||||||||  ||||||||  |||||||| |iiii|Ui|iiiii|",
        "a       |..gg.gj  |...m..j  |......j  |g...ggj  |mm..m.j ||||+||+|||+|||",
        "aaa     |g.....j  |.m...mj  |gg.g.gj  |g.g...j  |......j |iiiiiiiiiiiiio",
        ";;aaa   ||||||||  ||||||||  ||||||||  ||||||||  |||||||| +iiiiiiiiiiii||",
        ";;;;aaa                                                  oiiiiiDFiiid||;",
        ";;;;;;aaaaaaaaaaaaaaaaaaaaaaaaaaaaaaaaaaaaaaaaaaaaaaaaaaa||||o|||||o||;;",
        ";;;;;;;;;;;;;;;;;;;;;;;;;;;;;;;;;;;;;;;;;;;;;;;;;;;;;;;;;;;;;;;;;;;;;;;;",
        ";;;;;;;;;;;;;;;;;;;;;;;;;;;;;;;;;;;;;;;;;;;;;;;;;;;;;;;;;;;;;;;;;;;;;;;;",
        ";;;;;;;;;;;;;;;;;;;;;;;;;;;;;;;;;;;;;;;;;;;;;;;;;;;;;;;;;;;;;;;;;;;;;;;;"
      ],
      "vendingmachines": { "D": { "item_group": "vending_drink" }, "F": { "item_group": "vending_food" } },
      "toilets": { "t": {  } },
      "gaspumps": { "!": {  } },
      "items": {
        "Q": { "item": "cannedfood", "chance": 50, "repeat": [ 1, 3 ] },
        "S": { "item": "SUS_bathroom_cabinet", "chance": 100 },
        "g": { "item": "mansion_safe", "chance": 100, "repeat": [ 1, 2 ] },
        "m": { "item": "vault", "chance": 100, "repeat": [ 1, 2 ] }
      },
      "furniture": {
        "C": "f_workbench",
        "c": "f_cupboard",
        "1": "f_control_station",
        "A": "f_air_compressor",
        "f": "f_tourist_table",
        "&": "f_cleat",
        "@": "f_bed",
        "B": "f_sample_freezer",
        "E": "f_shaker",
        "G": "f_stool",
        "H": "f_counter",
        "I": "f_IV_pole",
        "J": "f_curtain",
        "K": "f_fridge",
        "Q": "f_rack",
        "S": "f_sink",
        "U": "f_shower",
        "W": "f_water_purifier",
        "b": "f_bench",
        "h": "f_camp_chair",
        "l": "f_foot_locker",
        "g": "f_crate_c",
        "m": "f_crate_c"
      },
      "terrain": {
        " ": "t_bulkhead_floor",
        "`": "t_bulkhead_roof",
        ";": "t_lake_bed",
        "+": "t_door_metal_bulkhead_c",
        "#": "t_metal_pontoon_dp",
        "2": "t_machinery_electronic",
        "j": "t_door_metal_locked",
        "*": "t_water_pool",
        "m": "t_metal_floor",
        "-": "t_water_cube",
        ".": "t_metal_floor",
        "<": "t_ladder_up",
        "|": "t_wall_bulkhead",
        ">": "t_ladder_down",
        "~": "t_water_dp",
        "A": "t_metal_floor",
        "P": "t_concrete_dock_deep_pile",
        "^": "t_lake_bed_concrete",
        "o": "t_porthole",
        "y": "t_lake_bed_concrete_yellow",
        "@": "t_bulkhead_floor",
        "a": "t_metal_railing",
        "d": "t_stairs_up",
        "e": "t_stairs_down",
        "g": "t_metal_floor",
        "i": "t_bulkhead_floor"
      }
    }
  },
  {
    "type": "overmap_terrain",
    "id": [
      "cargo_ship_a",
      "cargo_ship_b",
      "cargo_ship_c",
      "cargo_ship_1_a",
      "cargo_ship_1_b",
      "cargo_ship_1_c",
      "cargo_ship_2_a",
      "cargo_ship_2_b",
      "cargo_ship_2_c"
    ],
    "name": "sunken cargo ship",
    "sym": "S",
    "color": "light_gray",
    "see_cost": 1
  },
  {
    "type": "overmap_special",
    "id": "sunken_cargo_ship",
    "rotate": false,
    "overmaps": [
      { "point": [ 0, 0, -5 ], "overmap": "cargo_ship_a_east", "locations": [ "lake_bed" ] },
      { "point": [ 0, 1, -5 ], "overmap": "cargo_ship_b_east", "locations": [ "lake_bed" ] },
      { "point": [ 0, 2, -5 ], "overmap": "cargo_ship_c_east", "locations": [ "lake_bed" ] },
      { "point": [ 0, 0, -4 ], "overmap": "cargo_ship_1_a_east", "locations": [ "lake_water_cube" ] },
      { "point": [ 0, 1, -4 ], "overmap": "cargo_ship_1_b_east", "locations": [ "lake_water_cube" ] },
      { "point": [ 0, 2, -4 ], "overmap": "cargo_ship_1_c_east", "locations": [ "lake_water_cube" ] },
      { "point": [ 0, 0, -3 ], "overmap": "cargo_ship_2_a_east", "locations": [ "lake_water_cube" ] },
      { "point": [ 0, 1, -3 ], "overmap": "cargo_ship_2_b_east", "locations": [ "lake_water_cube" ] },
      { "point": [ 0, 2, -3 ], "overmap": "cargo_ship_2_c_east", "locations": [ "lake_water_cube" ] }
    ],
    "locations": [ "lake_surface" ],
    "occurrences": [ 0, 3 ],
    "city_distance": [ 20, -1 ],
    "flags": [ "LAKE" ]
  }
]
